5 1 1 1 1 1 1 1 5
5 0 0 0 0 0 0 0 5
5 0 0 0 4 0 0 0 5
5 0 0 0 4 0 0 0 5
5 0 0 2 4 3 3 0 5
5 0 2 2 3 0 0 0 5
5 0 0 0 3 0 4 0 5
5 0 0 0 3 0 0 0 5
5 0 0 0 0 0 0 0 5
5 0 0 0 0 0 0 0 5
5 0 4 0 0 0 0 0 5
5 0 4 4 0 0 0 0 5
5 0 0 4 0 0 0 0 5
5 0 0 0 0 0 4 0 5
5 0 0 0 0 4 0 0 5
5 0 0 0 0 0 0 0 5
5 1 1 1 1 1 1 1 5
